11111111111111111111
1E0011100000Y00000C1
11101110100100111111
11101110100100111111
1P100000000000C00001
10000000C0Y000000001
11111111111111111111