1111111111111111111
1E000000Y000000CY01
1010010100100000001
1010010010101010001
1P0000Y00C00C000C01
1111111111111111111